***************************************
* *                      *            *
* *      *              **            *
*        *               *            *
****     *       *           *        *
*        *                *           *
*        *                *           *
*        *                ****** ******
*        **               *           *
*  ****                   *           *
*                     **  *           *
*              *                      *
*              *                      *
***************************************